+---+---+---+---+---+---+---+---+---+---+
| S     |                   |           |
+---+   +---+   +   +   +---+   +   +---+
|   |       |   |   |   |       |       |
+   +---+   +---+   +---+   +---+---+   +
|       |       |           |           |
+   +---+---+   +---+---+---+   +---+   +
|           |               |       |   |
+---+   +   +---+   +   +   +---+   +   +
|       |       |   |   |           |   |
+   +---+   +---+---+---+---+---+---+   +
|       |   |                   |       |
+---+   +---+   +   +---+---+   +   +---+
|       |       |       |       |   |   |
+   +   +   +---+---+   +---+---+   +   +
|   |   |       |   |   |           |   |
+   +---+---+   +   +   +   +---+---+   +
|       |       |   |   |   |           |
+   +   +   +---+   +   +   +---+---+   +
|   |               |       |         E |
+---+---+---+---+---+---+---+---+---+---+
