+---+---+---+---+---+
| S         |       |
+---+---+   +---+   +
|       |           |
+   +---+   +   +   +
|   |       |   |   |
+   +---+---+   +---+
|   |       |   |   |
+   +   +   +   +   +
|       |       | E |
+---+---+---+---+---+
